tileset.png 7 38 38
20 20
4 4 4 4 4 4 4 4 4 4 4 4 4 4 4 4 4 4 4 4
4 1 1 1 1 4 4 4 4 4 1 1 1 1 4 4 4 4 4 4
4 4 1 1 1 1 1 4 4 4 4 1 1 1 1 1 1 4 4 4
4 4 1 1 1 1 1 1 1 1 1 1 1 1 1 1 1 1 1 4
4 4 1 1 1 1 1 1 1 1 1 1 1 1 1 1 1 1 1 4
4 1 1 1 1 1 1 3 3 3 3 1 1 1 1 1 1 3 4 4
4 1 1 1 1 1 1 1 1 1 3 3 1 1 1 1 1 1 1 4
4 4 1 1 1 1 1 1 3 3 3 3 1 1 1 1 1 1 1 4
4 4 1 1 1 1 1 1 3 3 3 3 1 1 1 1 1 1 1 4
4 4 3 1 1 3 3 3 3 3 3 3 3 3 3 3 3 3 4 4
4 4 3 1 1 3 3 3 3 3 3 3 3 3 3 3 3 3 4 4
4 1 1 1 1 3 3 3 3 3 1 1 1 1 3 3 3 3 4 4
4 4 1 1 1 1 1 3 3 3 3 1 1 1 1 1 1 3 4 4
4 4 1 1 1 1 1 1 1 1 1 1 1 1 1 1 1 1 1 4
4 4 1 1 1 1 1 1 1 1 1 1 1 1 1 1 1 1 1 4
4 1 1 1 1 1 1 3 3 3 3 1 1 1 1 1 1 3 4 4
4 1 1 1 1 1 1 1 3 3 3 3 1 1 1 1 1 1 1 4
4 4 1 1 1 1 1 1 3 3 3 3 1 1 1 1 1 6 1 4
4 4 1 1 1 1 1 1 4 4 4 4 1 1 1 1 1 1 1 4
4 4 4 4 4 4 4 4 4 4 4 4 4 4 4 4 4 4 4 4
